&&&&&&&&&&&&&&&&&&&&&
&&&&&&&&&&&&&&&&&&&&&
&&&&&&&&&&&&&&&&&&&&&
&&&&&&&&&&&&&&&&&&&&&
&&&&&&&&&&&&&&&&&&&&&
&&&&&&&&&&&&&&&&&&&&&
&&&&&&&&&&&&&&&&&&&&&
&&&&&&&&&&&&&&&&&&&&&
&&&&&&&&&&&&&&&&&&&&&
&&&&&&&&&&&&&&&&&&&&&
&&&&&&&&&&&&&&&&&&&&&
&&&&&&&&&&&&&&&&&&&&&
&&&&&&&&&&&&&&&&&&&&&
&&&&&&&&&&&&&&&&&&&&&
&&&&&&&&&&&&&&&&&&&&&
>
                     
                     
                     
                     
                     
                     
                     
                     
                     
                     
                     
                     
                     
                     
                     
>
########## ##########
########## ##########
##      ##         ##
##      ##         ##
##      ##         ##
##      ##         ##
##      ##         ##
##                   
##      #############
##      #############
##      #############
##                 ##
##                 ##
#####################
#####################
>
