&&&&&&&&&&&&&&&&&&&&&
&&&&&&&&&&&&&&&&&&&&&
&&&&&&&&&&&&&&&&&&&&&
&&&&&&&&&&&&&&&&&&&&&
&&&&&&&&&&&&&&&&&&&&&
&&&&&&&&&&&&&&&&&&&&&
&&&&&&&&&&&&&&&&&&&&&
&&&&&&&&&&&&&&&&&&&&&
&&&&&&&&&&&&&&&&&&&&&
&&&&&&&&&&&&&&&&&&&&&
&&&&&&&&&&&&&&&&&&&&&
&&&&&&&&&&&&&&&&&&&&&
&&&&&&&&&&&&&&&&&&&&&
&&&&&&&&&&&&&&&&&&&&&
&&&&&&&&&&&&&&&&&&&&&
>
                     
                     
                     
                     
                     
                     
                     
                     
                     
                     
                     
                     
                     
                     
                     
>
########## ##########
########## ##########
##                 ##
##                 ##
##    ##     ##    ##
##    ##     ##    ##
##    ##     ##    ##
      ##     ##      
##    ##     ##    ##
##    ##     ##    ##
##    ##     ##    ##
##                 ##
##                 ##
########## ##########
########## ##########
>
