:::::::::::::::::::::
:::::::::::::::::::::
:::::::::::::::::::::
:::::::::::::::::::::
:::::::::::::::::::::
:::::::::::::::::::::
:::::::::::::::::::::
:::::::::::::::::::::
:::::::::::::::::::::
:::::::::::::::::::::
:::::::::::::::::::::
:::::::::::::::::::::
:::::::::::::::::::::
:::::::::::::::::::::
:::::::::::::::::::::
>
                     
                     
                     
                     
                     
                     
                     
                     
                     
                     
                     
                     
                     
                     
                     
>
########## ##########
########## ##########
##                 ##
##                 ##
##                 ##
##     #######     ##
##     #######     ##
       #######       
##     #######     ##
##     #######     ##
##                 ##
##                 ##
##                 ##
########## ##########
########## ##########
>
