<<<<<<<<<<<<<<<<<<<<<
<<<<<<<<<<<<<<<<<<<<<
<<<<<<<<<<<<<<<<<<<<<
<<<<<<<<<<<<<<<<<<<<<
<<<<<<<<<<<<<<<<<<<<<
<<<<<<<<<<<<<<<<<<<<<
<<<<<<<<<<<<<<<<<<<<<
<<<<<<<<<<<<<<<<<<<<<
<<<<<<<<<<<<<<<<<<<<<
<<<<<<<<<<<<<<<<<<<<<
<<<<<<<<<<<<<<<<<<<<<
<<<<<<<<<<<<<<<<<<<<<
<<<<<<<<<<<<<<<<<<<<<
<<<<<<<<<<<<<<<<<<<<<
<<<<<<<<<<<<<<<<<<<<<
>
         @@@         
 @@@@@@@@@@@@@@@@@@@ 
 @@@@@@@@@@@@@@@@@@@ 
 @@                  
 @@                  
 @@                  
 @@                  
 @@                  
 @@                  
 @@                  
 @@                  
 @@                  
 @@                  
 @@                  
                     
>
########## ##########
########## ##########
##                 ##
##                 ##
##                 ##
##                 ##
##                 ##
##                 ##
##                 ##
##                 ##
##                 ##
##                 ##
##                 ##
#####################
#####################
>
