<<<<<<<<<<<<<<<<<<<<<
<<<<<<<<<<<<<<<<<<<<<
<<<<<<<<<<<<<<<<<<<<<
<<<<<<<<<<<<<<<<<<<<<
<<<<<<<<<<<<<<<<<<<<<
<<<<<<<<<<<<<<<<<<<<<
<<<<<<<<<<<<<<<<<<<<<
<<<<<<<<<<<<<<<<<<<<<
<<<<<<<<<<<<<<<<<<<<<
<<<<<<<<<<<<<<<<<<<<<
<<<<<<<<<<<<<<<<<<<<<
<<<<<<<<<<<<<<<<<<<<<
<<<<<<<<<<<<<<<<<<<<<
<<<<<<<<<<<<<<<<<<<<<
<<<<<<<<<<<<<<<<<<<<<
>
        @@@          
 @@@@@@@@@@@@@@@@@@@ 
 @@@@@@@@@@@@@@@@@@  
 @@                  
 @@                  
@@@                  
@@@                  
@@                   
@@@                  
@@@                  
@@@                  
 @@                  
 @@                  
 @@                  
                     
>
########## ##########
########## ##########
##                 ##
##                 ##
##                 ##
##                 ##
##                 ##
                   ##
##                 ##
##                 ##
##                 ##
##                 ##
##                 ##
#####################
#####################
>
