<<<<<<<<<<<<<<<<<<<<<
<<<<<<<<<<<<<<<<<<<<<
<<<<<<<<<<<<<<<<<<<<<
<<<<<<<<<<<<<<<<<<<<<
<<<<<<<<<<<<<<<<<<<<<
<<<<<<<<<<<<<<<<<<<<<
<<<<<<<<<<<<<<<<<<<<<
<<<<<<<<<<<<<<<<<<<<<
<<<<<<<<<<<<<<<<<<<<<
<<<<<<<<<<<<<<<<<<<<<
<<<<<<<<<<<<<<<<<<<<<
<<<<<<<<<<<<<<<<<<<<<
<<<<<<<<<<<<<<<<<<<<<
<<<<<<<<<<<<<<<<<<<<<
<<<<<<<<<<<<<<<<<<<<<
>
                     
 @@@@@@@@@@@@@@@@@@@ 
 @@@@@@@@@@@@@@@@@@@ 
 @@                  
 @@                  
 @@                  
 @@                @@
 @@                @@
 @@                  
 @@                  
 @@                  
 @@                  
 @@                  
 @@                  
                     
>
#####################
#####################
##                 ##
##                 ##
##                 ##
##                 ##
##                 ##
##                   
##                 ##
##                 ##
##                 ##
##                 ##
##                 ##
#####################
#####################
>
