<<<<<<<<<<<<<<<<<<<<<
<<<<<<<<<<<<<<<<<<<<<
<<<<<<<<<<<<<<<<<<<<<
<<<<<<<<<<<<<<<<<<<<<
<<<<<<<<<<<<<<<<<<<<<
<<<<<<<<<<<<<<<<<<<<<
<<<<<<<<<<<<<<<<<<<<<
<<<<<<<<<<<<<<<<<<<<<
<<<<<<<<<<<<<<<<<<<<<
<<<<<<<<<<<<<<<<<<<<<
<<<<<<<<<<<<<<<<<<<<<
<<<<<<<<<<<<<<<<<<<<<
<<<<<<<<<<<<<<<<<<<<<
<<<<<<<<<<<<<<<<<<<<<
<<<<<<<<<<<<<<<<<<<<<
>
                     
@@@@@@@@@@@@@@@@@@@@@
@@@@@@@@@@@@@@@@@@@@@
@@                 @@
@@@                @@
@@@                @@
@@@           @@   @@
             @@@     
      @@@@@@@@@@     
 @@   @@@@@@@@@@     
@@@                @@
@@@                @@
@@                   
@@                   
                     
>
WWWWWWWWWWWWWWWWWWWWW
WWWWWWWWWWWWWWWWWWWWW
W                   W
WW                 WW
WW                 WW
WW    WWWWWWWWW    WW
      WWWWWWWWW      
      WWWWWWWWW      
WW    WWWWWWWWW    WW
WW                 WW
WW                 WW
W                   W
W                   W
WWWWWWWWWWWWWWWWWWWWW
WWWWWWWWWWWWWWWWWWWWW
>
