<<<<<<<<<<<<<<<<<<<<<
<<<<<<<<<<<<<<<<<<<<<
<<<<<<<<<<<<<<<<<<<<<
<<<<<<<<<<<<<<<<<<<<<
<<<<<<<<<<<<<<<<<<<<<
<<<<<<<<<<<<<<<<<<<<<
<<<<<<<<<<<<<<<<<<<<<
<<<<<<<<<<<<<<<<<<<<<
<<<<<<<<<<<<<<<<<<<<<
<<<<<<<<<<<<<<<<<<<<<
<<<<<<<<<<<<<<<<<<<<<
<<<<<<<<<<<<<<<<<<<<<
<<<<<<<<<<<<<<<<<<<<<
<<<<<<<<<<<<<<<<<<<<<
<<<<<<<<<<<<<<<<<<<<<
>
                     
 @@@@@@@@@@@@@@@@@@@ 
 @@@@@@@@@@@@@@@@@@@ 
 @@                  
 @@                  
 @@                  
 @@                  
 @@                  
 @@                  
 @@                  
 @@                  
 @@                  
 @@                  
 @@     @@@          
        @@@          
>
#####################
#####################
##                 ##
##                 ##
##                 ##
##                 ##
##                 ##
##                 ##
##                 ##
##                 ##
##                 ##
##                 ##
##                 ##
########## ##########
########## ##########
>
