<<<<<<<<<<<<<<<<<<<<<
<<<<<<<<<<<<<<<<<<<<<
<<<<<<<<<<<<<<<<<<<<<
<<<<<<<<<<<<<<<<<<<<<
<<<<<<<<<<<<<<<<<<<<<
<<<<<<<<<<<<<<<<<<<<<
<<<<<<<<<<<<<<<<<<<<<
<<<<<<<<<<<<<<<<<<<<<
<<<<<<<<<<<<<<<<<<<<<
<<<<<<<<<<<<<<<<<<<<<
<<<<<<<<<<<<<<<<<<<<<
<<<<<<<<<<<<<<<<<<<<<
<<<<<<<<<<<<<<<<<<<<<
<<<<<<<<<<<<<<<<<<<<<
<<<<<<<<<<<<<<<<<<<<<
>
                     
@@@@@@@@@@@@@@@@@@@  
@@@@@@@@@@@@@@@@@@@@ 
 @@                  
 @@                  
 @@                  
@@@                  
@@@                  
                     
 @@                  
 @@                  
 @@                  
 @@                  
 @@      @@          
         @@          
>
#####################
#####################
##                 ##
##                 ##
##                 ##
##                 ##
##                 ##
                   ##
##                 ##
##                 ##
##                 ##
##                 ##
##                 ##
########## ##########
########## ##########
>
