<<<<<<<<<<<<<<<<<<<<<
<<<<<<<<<<<<<<<<<<<<<
<<<<<<<<<<<<<<<<<<<<<
<<<<<<<<<<<<<<<<<<<<<
<<<<<<<<<<<<<<<<<<<<<
<<<<<<<<<<<<<<<<<<<<<
<<<<<<<<<<<<<<<<<<<<<
<<<<<<<<<<<<<<<<<<<<<
<<<<<<<<<<<<<<<<<<<<<
<<<<<<<<<<<<<<<<<<<<<
<<<<<<<<<<<<<<<<<<<<<
<<<<<<<<<<<<<<<<<<<<<
<<<<<<<<<<<<<<<<<<<<<
<<<<<<<<<<<<<<<<<<<<<
<<<<<<<<<<<<<<<<<<<<<
>
         @@@         
  @@@@@@@@@@@@@@@@@@ 
 @@@@@@@@@@@@@@@@@@@ 
 @@                  
 @@                  
 @@                  
@@@                  
@@                   
@@@                  
@@@                  
@@@                  
 @@                  
 @@                  
 @@@@@@@@@@          
         @@@         
>
########## ##########
########## ##########
##                 ##
##                 ##
##                 ##
##                 ##
##                 ##
                   ##
##                 ##
##                 ##
##                 ##
##                 ##
##                 ##
########## ##########
########## ##########
>
