<<<<<<<<<<<<<<<<<<<<<
<<<<<<<<<<<<<<<<<<<<<
<<<<<<<<<<<<<<<<<<<<<
<<<<<<<<<<<<<<<<<<<<<
<<<<<<<<<<<<<<<<<<<<<
<<<<<<<<<<<<<<<<<<<<<
<<<<<<<<<<<<<<<<<<<<<
<<<<<<<<<<<<<<<<<<<<<
<<<<<<<<<<<<<<<<<<<<<
<<<<<<<<<<<<<<<<<<<<<
<<<<<<<<<<<<<<<<<<<<<
<<<<<<<<<<<<<<<<<<<<<
<<<<<<<<<<<<<<<<<<<<<
<<<<<<<<<<<<<<<<<<<<<
<<<<<<<<<<<<<<<<<<<<<
>
   @@@   @@@         
 @@@@@@@@@@@@@@@@@@@@
 @@@@@@@@@@@@@@@@@@@ 
 @@                  
 @@                  
 @@                  
 @@                @@
 @@                @@
 @@                  
 @@                  
 @@                  
 @@                  
 @@                  
 @@      @@          
 @       @@          
>
########## ##########
########## ##########
##                 ##
##                 ##
##                 ##
##                 ##
##                 ##
##                   
##                 ##
##                 ##
##                 ##
##                 ##
##                 ##
########## ##########
########## ##########
>
