<<<<<<<<<<<<<<<<<<<<<
<<<<<<<<<<<<<<<<<<<<<
<<<<<<<<<<<<<<<<<<<<<
<<<<<<<<<<<<<<<<<<<<<
<<<<<<<<<<<<<<<<<<<<<
<<<<<<<<<<<<<<<<<<<<<
<<<<<<<<<<<<<<<<<<<<<
<<<<<<<<<<<<<<<<<<<<<
<<<<<<<<<<<<<<<<<<<<<
<<<<<<<<<<<<<<<<<<<<<
<<<<<<<<<<<<<<<<<<<<<
<<<<<<<<<<<<<<<<<<<<<
<<<<<<<<<<<<<<<<<<<<<
<<<<<<<<<<<<<<<<<<<<<
<<<<<<<<<<<<<<<<<<<<<
>
   @@    @@@@@       
 @@@@@@@@@@@@@@@@@@@ 
@@@@@@@@@@@@@@@@@@@@@
 @@                  
 @@                 @
@@@                @@
@@@                @@
@@@                @@
@@@                @@
@@@                  
@@@                  
 @@                  
 @@                  
 @@@@@@@@@@          
         @@          
>
########## ##########
########## ##########
##                 ##
##                 ##
##                 ##
##                 ##
##                 ##
                     
##                 ##
##                 ##
##                 ##
##                 ##
##                 ##
########## ##########
########## ##########
>
