#######  #######
#######  #######
##            ##
##            ##
##            ##
##            ##
##            ##
##              
##              
##            ##
##            ##
##            ##
##            ##
##            ##
################
################