################
################
##            ##
##            ##
##            ##
##            ##
##            ##
##              
##              
##            ##
##            ##
##            ##
##            ##
##            ##
#######  #######
#######  #######